11111111111111111111111111111111
10000000000000000000000000000001
1000P000000000000000000000000001
10000000000000000000000000000001
10000000000000000000000000000001
10000000111110000001111100000001
10000000100000000000000100000001
10000000100000000000000100000001
10000000100000000000000100000001
10000000100000000000000100000001
10000000000000000000000000000001
10000000000000011000000000000001
10000000000000011000000000000001
10000000000000000000000000000001
10000000100000000000000100000001
10000000100000000000000100000001
10000000100000000000000100000001
10000000100000000000000100000001
10000000111110000001111100000001
10000000000000000000000000000001
10000000000000000000000000000001
10000000000000000000000000000001
10000000000000000000000000000001
11111111111111111111111111111111