1111111111111111111111111111111111111111111111111111111111111111
1000000000000000000000000000000000000000000000000000000000000001
1000P0000M000000000000000000000000000000000000000000000000000001
1000000000000000000000000000000000000000000000000000000000000001
1000000000000000000000000000000000000000000000000000000000000001
1000000011111000000111110000000100000000000000000000000000000001
1000000010000000000000010000000100000000000000000000000000000001
100000001000000M000000010000000100000000000000000000000000000001
1000000010000000000000010000000100000000000000000000000000000001
1000000010000000000000010000000100000000000000000000000000000001
1000000000000000000000000000000000000000000000000000000000000001
1000000000000001100000000000000000000000000000000000000000000001
1000000000000001100000000000000000000000000000000000000000000001
1000000000000000000000000000000000000000000000000000000000000001
1000000010000000000000010000000100000000000000000000000000000001
1000000010000000000000010000000100000000000000000000000000000001
1000000010000000000000010000000100000000000000000000000000000001
1000000010000000000000010000000100000000000000000000000000000001
1000000011111000000111110000000100000000000000000000000000000001
1000000000000000000000000000000000000000000000000000000000000001
1000000000000000000000000000000000000000000000000000000000000001
1000000000000000000000000000000000000000000000000000000000000001
1000000000000000000000000000000000000000000000000000000000000001
1111111111111111111111111111111111111111111111111111111111111111